 gb|   |   |g  |  s|w  |
  h|b  |   |   |   |s  |
  b|  g|   |p  |  b|h  |
   |   |   |   |   |b  |
   |  g|   |  b|   |g  |
   |   |  b|  h|b  |   |