s  |  b|   |   |b  |   |
w  |   |   |  b|h  |b  |
   |b  |   |   |b  |   |
 b |h  |b  | b |h  |b  |
   |b  |  g|   |b  | g |
   |   |   |   |   | p |