   |   | gb|  h|b  | p |
   |   |   |  b|   |   |
   |b  |   |   |   |   |
 b |h  |b  |   |s  |   |
   |b  |   |  s|w  |s  |
  g|   |   |   |s  |   |