 s |   |   |   |b  |   |
w  |s  |   |  b|h  |b  |
s  |b  |   |   |b  |   |
 b |h  |b  | b |h  |b  |
   |b  |  g|   |b  | g |
p  |   |   |   |   | g |