   |  s|  w|  s|b  | p |
   |   |  s|  b|h  |b  |
   |b  |   |   |b  |   |
 b |h  |b  | b |h  |b  |
   |b  |  g|   |b  |   |
  g|   |   |   |   | g |